1111111111111111111111111111111111111111
1E0000000000000C00000C000000000000000C01
1010010100100000101001000000010100CCSS01
1010010010101010001001000000010101111111
1P0000000C00C00S000000000000S000C0000001
100000000C00C0000S0000000S000000C0000001
100000000C00C00000000S0000000000C0000001
100000000C00C0000S0000000S000000C0000001
100000000C00C00000000S0000000000C0000001
100000000C00C0000S0000000S000000C0000001
100000000C00C00000000S0000000000C0000001
100000000C00C0000S0000000S000000C0000001
100000000C00C00000000S0000000000C0000001
100000000C00C0000S0000000S000000C0000001
100000000C00C0000S0000000S000000C0000001
100000000C00C0000S0000000S000000C0000001
100000000C00C0000S0000000S000000C0000001
100000000C00C0000S0000000S000000C0000001
100000000C00C0000S0000000S000000C0000001
100000000C00C0000S0000000S000000C0000001
1111111111111111111111111111111111111111