111111111111111111111
1E00000000000000000C1
1C00P0000000000000001
100000C00000000000001
100000000000000000001
111111111111111111111